XXXXXXXXXXXXXXXXXXXX
XXXXXXXXXXXXXXXXXXXX
X        XXX   XXX X
X XX XXX     X   X X
X    XXXXXXX XXX X X
XX XXXXXXXXX     X  
XX XXXX   XX XXXXXXX
XX XXXX X    XXXXXXX
XX XXXX X XXXXXXXXXX
   XXXX X   XXXX    
XXXX XX      XXX XXX
XXXX XX XXXX XXX XXX
XXXX XX  XX  X   XXX
XX   XXX    XX X   X
XX X XXXX  XXX XXXXX
XX X XXXXXXXXX XXXXX
XX X XX XXX         
XX XX      XXXXX XXX
XX XXX XXXXXXXXX XXX
XX XXXXXXXXXXXXXXXXX
10
13