X   XXXXX  X XXXXXXX
XXXXXX XX  X XXXXXXX
X XXXX XXXXX X   XXX
X XXXX XXXXXXX X    
X XXX        X XXXXX
  XXX XXX  X    XXXX
XXXXX  XX  XXXX XXXX
XXXXXX XX  XXXX  XXX
X   XX XXXXXXXXX  XX
XX XXX        XX XXX
XX XXXXXX  XX XX  XX
XX XXXXXX XXX XXX XX
XX   XXXX XXX X   XX
X  X XX   XXX X XXXX
XXXX XX XXXXXX  XXXX
XXX  XX  X XXXXXXX  
XXX XXXX X    XXX  X
XXX XXX  XX XXXXX XX
XX  XXXXXXX   XXX XX
XX XXXXXXXXXX XXX XX
10
10