XXXXXXXXXXXXXXXXXXXX
X                  X
X XXXXXXXXXXXXXXXX X
X X              X X
X X XXXXXXXXXXXX X X
X X X          X X X
X X X XXXXXX X X X X
X X X X      X X   X
X X X X XXXX X X X X
X X   X X  X X X X X
X X X X X  X X X X X
X X X X X XX X X X X
X X X X      X X X X
X X X XXXXXXXX X X X
X X X          X X X
X X XXXXXXXXXXXX X X
X X              X X
X XXXXXXXXXXXXXXXX X
X                  X
XXX XXXXXXXXXXXXXXXX
10
10