X XX               X
X XXXXXXXXXXXXXXXX X
X X              X X
X X              X X
X X              X X
X X              X X
X X              X X
X X              X X
X X              X X
X X              X X
X X              X X
X X              X X
X X              X X
X XXXXXX XXXXXXXXX X
X X  XXX XXXXXX XX X
X    XXX X  XXX XX X
XXX         XXX     
XXXXXXXXXXXXXXXXXXXX
XXXXXXXXXXXXXXXXXXXX
XXX              XXX
6
3